##################################################
#....O.##O...#.........#..#O........O....#..O.O..#
#.O#..#O......O..O#..O#O.....OOO....#..O......O..#
#.OO.O.O....#..O...#...#..O.OO#....OOO#...O....O.#
#.OO.OO..OO.O.#O...O..#.#.#....OOO#..O...........#
#..#....#.......OOO.O.......OOO.O....OO.O.....O.O#
#........#....O.O.#.#.....O.O...O....O.....O.#..##
#......O..OO#OOO.....O.#.O.##....OO#O.O.O.....O#.#
#.OOOO....#....O.....O..O..OO..O#........OO......#
#....O..........#.OOO.O....OO.O.OO...O.....#.....#
#.#.O.O.O..O.O..#......O..O...O......O.O..O......#
#..O.O.#...OO.OOO##.....#OO..O.O...OO.O.##..OOO..#
#OO....O..O....O...OO......#....O##..........OO..#
#..OO.#.O....O#...O..O.OO.#O.O...O..O#OO.#O...OO.#
#..#.O.....#.O.O..O#O...O.OOO.OO....O..#.O.......#
#....##OO...OOO....#.O.O.............#.......O#O.#
##.O.O.....#.......#..OO.OO.O..O.#O..O..O.......##
#.....O.O..#....#.OO......O...O..........OOO.O##O#
#.##OO#.O..O....O..O...OO..O....O#.....O..O.#....#
#..OO....O.#OO...O#...O.O..OO.#.OO.#O....O#..#...#
##.#O#OOO....#.O#.#..#O.O...O#.OOO.O#....O.O.....#
#.O....O..OOO.OOO.O.O..OO.O.#....O.O....O..O#O...#
#.O..O..O#O..O.O..O.O....O..#..OOO.....#..O...O..#
#..O....O#....O.....O...O....#....O..OO..........#
#.....OO....OO.O.#..O..#@#..O.O#.O.OO.OO..O.O....#
#OO..O......OO.O.#.#...OO#....O#.....#...##..O..O#
#O#O.#O.....O..OO#...OO.O........#.O.O........#.O#
#........#.O....#O.#.O...#...##O..O.O..#....OO#..#
#...OO.#O..O.O........OO.O.O.......OOO..#..O..O.O#
#OO..OOO.#...OO.O...OOO.OO...........O..O...O..OO#
#.O#O.....O....#.#...O.O..O.O...OO.....OOO..#O..O#
#.#O.#.....O.OOOOO.#OO..O.O....##.....OO.OO......#
#.O..OO.....#O.......#...O.O.O.O#....#O..O...O...#
#...OO.O.#OOOOO...O...#.....#....#......#OOOO..#.#
#....O...#.OO.........O..#O.O.O..O.....OOO...O...#
#O...O.......O..O.#..O.....OOO..O.OO....O#..O....#
#OO#...O.OO.........OO..O..O.#O...O.O.....#O.#O..#
##.O#......OO..#O#..O.....O#........O.O..OO....OO#
##.OO.....O.......O.#O..OOO.OO#O.OO.....O......O.#
#O.O.O...O..O.OO.O.........O.#.O.#.....O.O....#..#
#.....O.O.O.....#.#............#......#..O..#....#
#..O........#......O.O..O.O.........O.O.....O..O.#
#.O.#.O..OO....OO.......OO...O.O.....#O.OO.O.O...#
#O.O...#OO..O....#........O#.#....O.OO...O..#O..O#
#OO.....OO.#.....#...O#..#O.OO..OO#..#...O.O....O#
##O..O..O...OOOO#..O...............#....#O..O....#
#.....O.#..........O....#..O##O...O..O.#O.....O.O#
#O#...#..OOO#OO....O.O....#O.OO..O...O..O...O...O#
##.OO#.#..O...O.......#O.#.......O.O..O....O.##..#
##################################################
